W W W W W W W W W W W W
W E E E E E E E E E E W
W E E E W E W E E E E W
W E E E E W E E E E E W
W E E E W E W E E E E W
W E E W E E E W E E E W
W E E E W E W E E E E W
W E E E E W E E E E E W
W E E E W E W E E E E W
W E E W E E E W E E E W
W E E E E E E E E E E W
W W W W W W W W W W W W